00,00,00,00,00,00,00,00,00,00,00,00,00,00,00,00,00,00,00,00,00,00,00,00,00,00,00,00,00,00,00,00,00,00,00,00,00,00,00,00,00,00,00,00,00,00,00,00,00,00,00,00,00,00,00,00,00,00,00,00,00,00,00,00,00,00,00,00,00,00,00,00,00,00,00,00,00,00,00,00,00,00,00,00,00,00,00,00
00,00,00,00,00,00,00,00,00,00,00,00,00,00,00,00,00,00,00,00,00,00,00,00,00,00,00,00,00,00,00,00,00,00,00,00,00,00,00,00,00,00,00,00,00,00,00,00,00,00,00,00,00,00,00,00,00,00,00,00,00,00,00,00,00,00,00,00,00,00,00,00,00,00,00,00,00,00,00,00,00,00,00,00,00,00,00,00
00,00,00,00,00,00,00,00,00,00,00,00,00,00,00,00,00,00,00,00,00,00,00,00,00,00,00,00,00,00,00,00,00,00,00,00,00,00,00,00,00,00,00,00,00,00,00,00,00,00,00,00,00,00,00,00,00,00,00,00,00,00,00,00,00,00,00,00,00,00,00,00,00,00,00,00,00,00,00,00,00,00,00,00,00,00,00,00
00,00,00,00,00,00,00,00,00,00,00,00,00,00,00,00,00,00,00,00,00,00,00,00,00,00,00,00,00,00,00,00,00,00,00,00,00,00,00,00,00,00,00,00,00,00,00,00,00,00,00,00,00,00,00,00,00,00,00,00,00,00,00,00,00,00,00,00,00,00,00,00,00,00,00,00,00,00,00,00,00,00,00,00,00,00,00,00
00,00,00,00,00,00,00,00,00,00,00,00,00,00,00,00,00,00,00,00,00,00,00,00,00,00,00,00,00,00,00,00,00,00,00,00,00,00,00,00,00,00,00,00,00,00,00,00,00,00,00,00,00,00,00,00,00,00,00,00,00,00,00,00,00,00,00,00,00,00,00,00,00,00,00,00,00,00,00,00,00,00,00,00,00,00,00,00
00,00,00,00,00,00,00,00,00,00,00,00,00,00,00,00,00,00,00,00,00,00,00,00,00,00,00,00,00,00,01,02,02,02,03,00,00,00,00,00,00,00,00,00,00,00,01,02,02,02,02,02,03,00,00,00,00,00,00,00,00,00,00,00,00,00,00,00,00,00,00,00,00,00,00,00,00,00,00,00,00,00,00,00,00,00,00,00
00,00,00,00,00,00,00,00,00,00,00,00,00,00,00,00,00,00,00,00,00,00,00,00,00,00,00,00,00,00,10,11,11,15,06,00,00,00,00,00,00,00,00,00,00,00,10,11,11,11,11,15,06,00,00,00,00,00,01,02,02,02,02,03,00,00,00,00,00,00,00,00,00,00,00,00,00,00,00,00,00,00,00,00,00,00,00,00
00,00,00,00,00,00,00,00,00,00,00,00,00,00,00,00,00,00,00,00,00,00,00,00,00,00,00,00,00,00,00,00,00,04,14,02,02,03,00,00,00,00,00,00,00,00,00,00,00,00,00,04,06,00,00,00,00,00,10,11,15,16,11,12,00,00,00,00,00,00,00,00,00,00,00,00,00,00,00,00,00,00,00,00,00,00,00,00
00,00,00,00,00,00,00,00,00,00,00,00,00,00,00,00,00,00,00,00,01,02,02,02,02,02,03,00,00,00,00,00,00,10,11,11,11,12,00,00,00,00,00,00,00,00,00,00,00,00,00,04,06,00,00,00,00,00,00,00,04,06,00,00,00,00,00,00,00,00,00,00,00,00,00,00,00,00,00,00,00,00,00,00,00,00,00,00
00,00,00,00,00,00,00,00,00,00,00,00,00,00,00,00,00,00,00,00,10,11,11,11,11,11,12,00,00,00,00,00,00,00,00,00,00,00,00,00,00,00,00,00,00,00,00,00,00,00,00,04,06,00,00,00,00,00,00,00,04,06,00,00,00,00,00,00,00,00,00,00,00,00,00,00,00,00,00,01,02,02,02,02,02,02,02,02
00,00,00,00,00,00,00,00,00,00,00,00,00,00,00,00,00,00,00,00,00,00,00,00,00,00,00,00,00,00,00,00,00,00,00,00,00,00,00,00,00,00,00,00,00,00,00,00,00,00,00,04,06,00,00,00,00,00,00,00,04,06,00,00,00,00,00,00,00,00,00,00,00,00,00,00,00,00,00,04,05,05,05,05,05,05,05,05
00,00,00,00,00,00,00,00,00,01,02,02,02,02,02,02,03,00,00,00,00,00,00,00,00,00,00,00,00,00,00,00,00,00,00,00,00,00,00,00,00,00,00,00,00,00,01,02,02,02,02,13,14,02,03,00,00,00,00,00,04,14,02,02,03,00,00,00,00,00,00,00,00,00,00,00,00,00,01,13,05,05,05,05,05,05,05,05
00,00,00,00,00,00,00,00,00,10,11,11,11,11,11,11,12,00,00,00,00,00,00,00,00,00,00,00,00,00,00,00,00,00,00,00,00,00,00,00,00,00,00,00,00,00,10,11,11,11,11,11,11,11,12,00,00,00,00,00,04,16,11,11,12,00,00,00,00,00,00,00,00,00,00,01,02,02,13,08,08,08,08,08,08,08,08,08
00,00,00,00,00,00,00,00,00,00,00,00,00,00,00,00,00,00,00,00,00,00,00,00,00,00,00,00,00,00,00,00,00,00,01,02,03,00,00,00,00,00,00,00,00,00,00,00,00,00,00,00,00,00,00,00,00,00,00,00,04,06,00,00,00,00,00,00,00,00,00,01,02,02,02,13,08,08,08,08,08,08,08,08,08,08,08,08
00,00,00,00,00,00,00,00,00,00,00,00,00,00,00,00,00,00,00,00,00,00,00,00,00,00,00,01,03,00,00,00,00,01,13,05,14,03,00,00,00,00,01,03,00,00,00,00,00,00,00,00,00,00,00,00,00,00,00,00,04,06,00,00,00,00,00,00,00,01,02,13,08,08,08,08,08,08,08,08,08,08,08,08,08,08,08,08
00,00,00,00,00,00,00,00,00,00,00,00,00,00,00,00,00,00,00,00,00,00,00,00,00,00,00,04,06,00,00,00,00,10,11,11,11,12,00,00,00,00,04,06,00,00,00,00,00,00,00,00,00,00,00,00,00,00,00,00,04,06,00,00,00,00,00,00,00,04,05,08,08,08,08,08,08,08,08,08,08,08,08,08,08,08,08,08
02,02,02,02,02,02,02,02,02,02,02,02,02,02,02,02,02,02,02,02,02,02,02,02,02,02,02,13,06,00,00,00,00,00,00,00,00,00,00,00,00,00,04,14,02,02,02,02,02,02,02,02,02,02,02,02,02,02,02,02,13,14,02,02,02,02,02,02,02,13,08,08,08,08,08,08,08,08,08,08,08,08,08,08,08,08,08,08
05,05,05,05,05,05,05,05,05,05,05,05,05,05,05,05,05,05,05,05,05,05,05,05,05,05,05,05,06,00,00,00,00,00,00,00,00,00,00,00,00,00,04,05,05,05,05,05,05,05,05,05,05,05,05,05,05,05,05,05,05,05,05,05,05,05,05,05,05,08,08,08,08,08,08,08,08,08,08,08,08,08,08,08,08,08,08,08
05,05,05,05,05,05,05,05,05,05,05,05,05,05,05,05,05,05,05,05,05,05,05,05,05,05,05,05,06,00,00,00,00,00,00,00,00,00,00,00,00,00,04,05,05,05,05,05,05,05,05,05,05,05,05,05,05,05,05,05,05,05,05,05,05,05,05,05,08,08,08,08,08,08,08,08,08,08,08,08,08,08,08,08,08,08,08,08
08,08,08,08,08,08,08,08,08,08,08,08,08,08,08,08,08,08,08,08,08,08,08,08,08,08,08,08,09,00,00,00,00,00,00,00,00,00,00,00,00,00,07,08,08,08,08,08,08,08,08,08,08,08,08,08,08,08,08,08,08,08,08,08,08,08,08,08,08,08,08,08,08,08,08,08,08,08,08,08,08,08,08,08,08,08,08,08
08,08,08,08,08,08,08,08,08,08,08,08,08,08,08,08,08,08,08,08,08,08,08,08,08,08,08,08,09,00,00,00,00,00,00,00,00,00,00,00,00,00,07,08,08,08,08,08,08,08,08,08,08,08,08,08,08,08,08,08,08,08,08,08,08,08,08,08,08,08,08,08,08,08,08,08,08,08,08,08,08,08,08,08,08,08,08,08
08,08,08,08,08,08,08,08,08,08,08,08,08,08,08,08,08,08,08,08,08,08,08,08,08,08,08,08,09,00,00,00,00,00,00,00,00,00,00,00,00,00,07,08,08,08,08,08,08,08,08,08,08,08,08,08,08,08,08,08,08,08,08,08,08,08,08,08,08,08,08,08,08,08,08,08,08,08,08,08,08,08,08,08,08,08,08,08
08,08,08,08,08,08,08,08,08,08,08,08,08,08,08,08,08,08,08,08,08,08,08,08,08,08,08,08,09,00,00,00,00,00,00,00,00,00,00,00,00,00,07,08,08,08,08,08,08,08,08,08,08,08,08,08,08,08,08,08,08,08,08,08,08,08,08,08,08,08,08,08,08,08,08,08,08,08,08,08,08,08,08,08,08,08,08,08